
						 NO 				./textures/tree2.xpm42     
SO       		  		./textures/ruby.xpm42
WE ./textures/blue.xpm42
EA ./textures/rock.xpm42

	F      	    190,78,123
C 75, 206, 235






11111111111111111111111111111111111111111111
11111000011000000000100000000000001000000001
10000000101000000010000000000010000000011111
10000000110100000110000000001111000000001
1000000000000000001111000000000000000001
1100000000100000000000000000000000000001          
1100000000000000000000000001000000000001    	
11111111000110000N00000000010000000000011111
10000001100000110110000000110000100000000001
10000000000000000000000000000000000000011111
1000000000000000000000000000000000000001
1111111111111111111111111111111111111111