
      			    NO 				./textures/tree2.xpm42     
SO       		  		./textures/ruby.xpm42
WE ./textures/blue.xpm42
EA ./textures/rock.xpm42

   F      	    190,78,123
C 75, 206, 235






11111111111111111111111111111111111111101
1000000010000000000000000000001000000001
1000000010000000000000000000001000000001
1000000010000000000000000001111000000001
1000000000000000001111000000000000000001
1100000000000000000000000000000000000001
1100000000000000000000000001000000000001
11111111000000000N0000000001000000000001
1000000100000000000000000001000000000001
1000000000000000000000000000000000000001
1000000000000000000000000000000000000001
1111111111111111111111111111111111111111