
						 NO 				./textures/tree2.xpm42
SO       		  		./textures/ruby.xpm42
WE ./textures/blue.xpm42
EA ./textures/rock.xpm42

	F      	   190,78,123
C 75, 206, 235,






11111111111111111111111111111111111111111111
111110000110000000001000000000000010000000011
100000001010000000100000000000100000000111111
100000001101000001101000000011110010000011
100000000000000000111000000000001100001
1100000000100000000010000000000000100001
1100010000000000000000000001000000000001
111111111000110000N00000000010000000000011111
10000101100000110110000000110000100000000001
1000001100000000000000000000000000000011111
10000011100000000000000000000000000000001
1111111111111111111111111111111111111111
