                  
      


NO ./textures/tree2.xpm42     
SO ./textures/ruby.xpm42
WE ./textures/blue.xpm42
EA ./textures/rock.xpm42      


F 190,178,123
C 135,206,235







                       111111
                       100001
                       100001
11111111111111111      100001
10000010000000001      100001
10001000100110001      100001
1111111110001000111111110000111111111111
10101000000000000000000000000000000000001
10000000010110001111111100000000000010001
10101000010010001      1000E0000001110001
11101111111110001      100000000000010001
10000000000000001      111111111111110001
10000000100000001                   10001
11111111111111111                   10001
                          111111111110001
                          100000000000001
                          111111111100001
                                   111111