                  
      


NO ./textures/tree2.xpm42     
SO ./textures/ruby.xpm42
WE ./textures/blue.xpm42
EA ./textures/rock.xpm42      


F 190,178,123
C 135,206,235







11111111111111111111111111111111111111111
11111111111111111111111100001111111111111
11111111111111111111111100001111111111111
11111111111111111111111100001111111111111
10000010000000001111111100001111111111111
10001000100110001111111100001111111111111
11111111100010001111111100001111111111111
10101000000000000000000000000000000000001
10000000010110001111111100000000000010001
101010000100100011111111000000N0001110001
11101111111110001111111100000000000010001
10000000000000001111111111111111111110001
10000000100000001111111111111111111110001
11111111111111111111111111111111111110001
11111111111111111111111111111111111110001
11111111111111111111111111100000000000001
11111111111111111111111111111111111100001
11111111111111111111111111111111111111111