
						 NO 				./textures/tree2.xpm42
SO       		  		./textures/ruby.xpm42
WE ./textures/blue.xpm42
EA ./textures/rock.xpm42

	F      	   190,78,123
C 75, 206, 235,



1
111
11111111111111111111111111111111111111111111
111110000110000000001000000000000010000000001
100000001010000000100000000000100000000111111
100000001101000001101000000011110010000011
10000000000000000011 1000000000001 100001
1100000000100000000010000000000000100001
11000100000000000000000000010000000000011
11111 111000110000N0000000011000000000000111111111111111111
100001011000001101100000001 10000100000000001
10000011000000000000000000010000000011111111
1000001 100000000000000000000000000000001
1111111 11111111111111111111111111111111111111111111
1
1
1
1